
EA   ./textures/east_cubi.xpm
SO textures/south_cubi.xpm

NO   ./textures/north_cubi.xpm
            F         255,51,51                                                 
C                          0        ,                191,255
WE   ./textures/east_cubi.xpm

       11
 111111101
100000001
100000001
100000001
10000N001000000000000000000000000000000000000000000000000000000000000000000000000000000000000000000000000000000000000000000000000000000000000000000000000000000000000000000000000000000000000000000000000000000000000000000000000000000000000000000000000000000000000000000000000000000000000000000000000000000000000000000000000000000000000000000000000000000000000000000000000000000000000000000000000000000000000000000000000000000000000000000000000000000000000000000000000000000000000000000000000000000000000000000000000000000000000000000000000000000000000000000000000000000000000
100000001
100000001
100000001
100000001
100000001
100000001
100000001
100000001
100000001
100000001
100000001
100000001
100000001
100000001
100000001
100000001
100000001
100000001
100000001
100000001
100000001
100000001
100000001
100000001
 1111111
