WE ./assets/textures/xpm/brick_wall.xpm                          
                NO ./assets/textures/xpm/brick_wall.xpm
SO ./assets/textures/xpm/brick_wall.xpm
NO ;sk   
EA        ./assets/textures/xpm/brick_wall.xpm
            F         51,51,51                                                 
C    0,191,255
1111
111011
11S00011

1111111
