C   135,  206, 235
F   147, 112, 219
WE textures/wolfenstein/purple_stone.xpm

EA    textures/wolfenstein/wood.xpm

NO   textures/     wolfenstein/grey_stone.xpm
SO textures/wolfenstein/red_brick.xpm

11111111111111111
1000000000000001
11S1111111111111
11111111111111111