WE ./assets/textures/xpm/brick_wall.xpm                          
      NO             ./assets/textures/xpm/brick_wall.xpm
SO ./assets/textures/xpm/brick_wall.xpm     
EA        ./assets/textures/xpm/brick_wall.xpm
F         51,51,51                                               
C    0,19,255

111
111111
11S011
111111
1111
11111