WE ./assets/textures/xpm/brick_wall.xpm                          
                NO ./assets/textures/xpm/brick_wall.xpm
SO ./assets/textures/xpm/brick_wall.xpm
EA        ./assets/textures/xpm/brick_wall.xpm

1111
111011
11S00011