F 0,192,225                                          
C    0,191,255
1111
111011
11S00011