NO ./textures/north_cubi.xpm
SO ./textures/south_cubi.xpm
EA ./textures/east_cubi.xpm
WE ./textures/west_cubi.xpm

C 149,242,223
F 229,241,217

11111111111111
1001001
100N0011111111111111111111
1111111111111111111111