C   135,  206, 235
F   147, 112, 219

WE textures/wolfenstein/purple_stone.xpm

EA    textures/wolfenstein/wood.xpm

NO   textures/     wolfenstein/grey_stone.xpm
SO textures/wolfenstein/red_brick.xpm
C   135,  206, 235
F   147, 112, 219

11111111111
1000S0001111
1111111111111