WE textures/wolfenstein/purple_stone.xpm
SO textures/wolfenstein/red_brick.xpm
EA    textures/wolfenstein/wood.xpm
NO   textures/     wolfenstein/grey_stone.xpm
F   147, 112, 219
C   135,  206, 235

111111
10S0011
111111