WE textures/wolfenstein/grey_stone.xpm
NO textures/wolfenstein/purple_stone.xpm
SO textures/wolfenstein/red_brick.xpm
EA textures/wolfenstein/wood.xpm
F 17, 38, 64
C 218, 234, 235

NO 111111
111111111111
11100011 1010
1000W00111010
1111110000010
111 1111111