WE textures/wolfenstein/purple_stone.xpm
SO textures/wolfenstein/red_brick.xpm


EA    textures/wolfenstein/wood.xpm
NO   textures/     wolfenstein/grey_stone.xpm
F   147, 112, 219
C   135,  206, 235

111111111111
11100011 1010
1000W00111010
1111110000010
111 1111111