WE textures/wolfenstein/grey_stone.xpm
NO textures/wolfenstein/purple_stone.xpm
SO textures/wolfenstein/red_brick.xpm
EA textures/wolfenstein/wood.xpm
F 17, 38, 64
C 218, 234, 235
111111 1
10S0110000100000000000001
1011111111111111111111111111111111
1000110000000000111111001