WE textures/wolfenstein/grey_stone.xpm
NO textures/wolfenstein/purple_stone.xpm
SO textures/wolfenstein/red_brick.xpm
EA textures/wolfenstein/wood.xpm
F 17, 38, 64
C 218, 234, 235

1111111
10S011000100000000000001
1011111111111111111111111111111111