
SO textures/wolfenstein/red_brick.xpm
      
	F 147, 112, 219
EA    textures/wolfenstein/wood.xpm
NO   textures/     wolfenstein/grey_stone.xpm
C 135,  206, 235

WE textures/wolfenstein/purple_stone.xpm
11111
10001
10N01
10001
1111
			