WE ./textures/west.xpm 
NO ./textures/north.xpm
SO ./textures/south.xpm
EA ./textures/east.xpm

F   147, 112, 219
C   135,  206, 235

1111111111111111111111111
1000000000011111100000001
1000000111000000000000111
1N11000000000000000000111
1000000000000000000000011
1111111111111111111111111