WE ./cubi_textures/west.xpm
SO ./cubi_textures/south.xpm

EA   ./cubi_textures/east.xpm
NO   ./cubi_textures/north.xpm
F   147, 112, 219
C   135,  206, 235

1111111111111111111111111
1111111111111111111111111
1111111111111111111111111
1111111111111111111111111
100010000100000000000001
100010000000000111110001
1001110000000001100000011
1001010000100000000001001
1001010000100000000001001
1001010000100001000001001
1000000000100000100001001
100000000010000N000001001
1000000000100000000001001
1000000000100000000001001
1111111111111111111111111
