1111111111111111111111111
100010000100000000000001
100010000000000111111001
100010000000000110001001
1000000000100000000001001
1000000000100000000001001
1000000000100000000001001
1000000000100000000001001
1000000000100000000001001
1000N00000100000000001001
1000000000100000000001001
1111111111111111111111111
