1111111111111111111111111
1111111111111111111111111
1111111111111111111111111
1111111111111111111111111
100010000100000000000001
100010000000000111111001
100010000000000110001001
1000000000100000000001001
100000000010000N000001001
1000000000100000000001001
1000000000100000000001001
1111111111111111111111111
