1111111111111111111111111
1111111111111111111111111
1111111111111111111111111
1111111111111111111111111
100010000100000000000001
100010000000000111110001
1001110000000001100000011
1001010000100000000001001
1001010000100000000001001
1001010000100000000001001

