WE ./assets/textures/xpm/brick_wall.xpm 


11111
1S11
111111
1  1 1